11111111
1P0000C1
10111101
1C0110E1
11111111