111111111111111111111111111111111111
110000000000000C00000C00000000000111
101001010010000010100100000001010111
101001101010101000100100111001010111
101001PE0C00C0000000000010100001C111
111111111111111111111111111111111111
111111111111111111111111111111111111
111111111111111111111111111111111111