11111
10C11
11111
1CPE1
11111
