11111
10011
10011
1CPE1
11111
