111111111111111111111111111111111111
10000000N000000C00000C0000C110000001
101000000000000000000000000110000001
1P1000000011111111110000000110001001
101000000010000000010000000110001001
1E1000000011110011110000N00110001001
10000000000000000000000E000000001C01
111111111111111111111111111111111111