11111111
1P0000C1
10111101
100C00E1
10CNC001
100C0001
11111111