111111111111111111111111111111111111
100000000000000C00000C00000000000001
101110000000000000000000000110000001
1P1C1010001011111101000N000110001001
10101010001C000000C10000000110001001
1E1000100011111011111011100110001001
101111100000000000000001100000001001
100000000N00000000000001100000000C01
101111111111111111111111111111111101
100000000000000000000000000000000001
111111111111111111111111111111111111