111111111111111111111111111111111111111111111111111111111111111111111111111111
100000000000000000000000000000000000000000000000000000000000000000000000000001
1000000P0000000000000000000000000000000C00000000000000000000000000000000000001
100000000000000000000000000000000000000000000000000000000000000000000000000001
100000000000000000000000000000000000000000000000000000000000000000000000000001
100000000000000000000000000000000000000000000000000000000000000000000000000001
100000000000000000000000000000000000000000000000000000000000000000000000000001
100000000000000000000000000000000000000000000000000000000000000000000000000001
100011000000000000000000000000000000000000000000000000000000000000000000000001
100011000000000000000000000000000000000000000000000000000000000000000000000001
100011000000000000000000000000000000000000000000000000000000000000000000000001
10C011000000000000000000000000000000000000000000000000000N00000000000001100001
111111000000000000000000000000000000000000000000000000000000000000000001100001
11111100000000000000000000000000000000000000000000000000000000000000000110N001
100000000000000000000000000001111000000000000000000000000000000000000001100001
100000000000000000000000000011101110000000000000000000000000000000000001100001
100000000000000000000000000111000111000000000000000000000000000000000001100001
100000000000000000000000001110000000000000000000000000000000000000000001100001
100000011111000011111111111111111111111111111111001111000000000000000001100001
100000011111000011111111111111111111111111111111001111000000000000000001100001
100000000000000000000000000000000000000000000000000000000000000000000001100001
10000000000000000000000000000000000000000000000000000000000000C000000001100001
1000C0000000000000000000000000000000000000000000000000000000000000000001100001
100000000000000000000000000000000000000000000000000000000000000000000001100001
100001100000000000000000000000000000000000000000000000000000000000000001100001
100001100000000000000000000000000001001000000000000000000000000000000001100001
100001100000000000000000000111111111001111110000000000000000000000000001100001
100001100000000000000000000100000000000000010000000000000000000000000001100001
100001100000000000000000000100000000000000010000000000000000000000000001100001
10000110000000000N00000000010000000E000000010000000000000000000000000001100001
100001100000000000000000000111111111111111110000000000000000000000000001100001
100001100000000000000000000000000000000000000000000000000000000000000001100001
100001100000000000000000000000000000000000000000000000000000000000000001100001
100001100000000000000000000000000000000000000000000000000000000000000001100001
100001100000000000000000000000000000000000000000000000000000000000000001100001
100001111111111111111111110011111111111111111111111111111000000000000N01100001
10000111111111111111111111001111111111111111111111111111100000000000000110C001
100000000000000000000000000000000000000000000000000000000000000000000001100001
10C000000000000000000000000000000000000000000000000000000000000000000001100001
100000000000000000000000000000000000000000000000000000000000000000000000000001
111111111111111111111111111111111111111111111111111111111111111111111111111111
